1111111111111111
1C01000V0001C001
1000010001000V01
1P0011E00C010001
101110001V0010C1
1111111111111111