11111111111111
100C00110010C1
1011V000000011
10000001110001
110110001000V1
10000000000111
11101V00110011
1E100000C10001
10100100000011
10001100011001
100100V0001101
10100000001C01
10V00110000101
11000C01P00011
11111111111111