1111111111111111111111111111111111
11000C001000000C00000C000001E00001
1C10010100100000101001000V001101V1
1010010010C010100010010001000100C1
10V000001000101000VC00000100000001
1000100100000000101001000V00100101
100010001010101000000C000000010001
1010010010001010001001001000010001
1010010010101010001000001C00110101
1P0000000C00CV100001100010000000C1
1010010100100000101001000000010101
1000V10010001010000010001000010C01
100000001010101C00001100110001V101
101C01010010000010100C100V00010101
1111111111111111111111111111111111